1111111111111111111111
1E0000000010000C000001
1000011100100000101001
1011110010101010101001
101000000C00C000100001
101011110C111000111101
100001001110C000001001
1P0111000C00C000000001
1111111111111111111111