1111111111111111111111
1E10000000100000000001
1010011100100000101001
1C11110010101010101001
1P10000000000001100001
1000011100111000000101
1011010011100001101001
1001000000000000100001
1111111111111111111111