1111111111111111111111
1E1000000010C000000001
1010011100100000101001
1011110010101010101001
1010000000000C01100001
100001110C111000P00101
1C11010011100001101001
10010000000000C0100001
1111111110001111111111
11000000010C0000000011
1010011100100000101001
1011110010101010101001
1010000000000C01100001
100001110C111000000101
1C11010011100001101001
10010000000000C0100001
1111111111111111111111