1111111111111111111111
1E1000000010000C000001
1010011100100000101001
1011110010101010101001
101000000C00C001100001
100001110C11100P000101
101101001110C001101001
10C100000C00C000100001
1111111111111111111111