1111111111111111111111
1C000000C000C0000000X1
1111111111111111111101
1E00000P00000000000001
1111111111111111111111